00011111
11100111
00000001
11111111
01010001
